000000000000000
0b0b0b0b0b0b0b0
b0000000000000b
0b0b0b0b0b0b0b0
000000000000000
0b0b0b0b0b0b0b0
000000000000000
0b0b0b0b0b0b0b0
000000000000000
0b0b0b0b0b0b0b0
000000000000000
0b0b0b0b0b0b0b0
b0000000000000b
0b0b0b0b0b0b0b0
00bbbbbbbbbbb00